██████████████████████████████████████████████████
██████████████████████████████████████████████████
██████████████████████████████████████████████████
██████████████████████████████████████████████████
██████████████████████████████████████████████████
██████████████████████████████████████████████████
██████████████████████████████████████████████████
██████████████████████████████████████████████████
████████████████████████    ██████████████████████
███████████████████              █████████████████
███████████████                          █████████
██████████                                    ████
██████                                            
████                                              
█                                                 
                                                  
                                                  
                               ██                 
                      ███   █████       █         
                    █████████████████ ███         
                   ██████████████████████         
                  █████████████████████           
                  ██████████████████████          
                  ██████████████████████          
                 █████████████████████            
                 ████████████████████             
                  ██████████████████              
                  ████████████████                
                 ███████████████                  
                ██████████████                    
█                 ███████████                     
███               █████████                       
████              ███████                         
█████              ████                           
███████                                           
████████                                          
██████████                                      ██
████████████                                ██████
██████████████                         ███████████
████████████████                   ███████████████
█████████████████              ███████████████████
██████████████████        ████████████████████████
████████████████████  ████████████████████████████
██████████████████████████████████████████████████
██████████████████████████████████████████████████
██████████████████████████████████████████████████
██████████████████████████████████████████████████
██████████████████████████████████████████████████
██████████████████████████████████████████████████
██████████████████████████████████████████████████