██████████████████████████████████████████████████
██████████████████████████████████████████████████
██████████████████████████████████████████████████
██████████████████████████████████████████████████
██████████████████████████████████████████████████
██████████████████████████████████████████████████
██████████████████████████████████████████████████
██████████████████████████████████████████████████
████████████████████████    ██████████████████████
███████████████████              █████████████████
███████████████                          █████████
██████████                                    ████
██████                                            
████                                              
█                                                 
                                                  
                                                  
                                                  
                                                  
                                                  
                        █  █                      
                      ███████ █                   
                     ██████████                   
                   █████████████                  
                   ███████████                    
                  ███████████                     
                  ██████████                      
                  █████████                       
                 ████████                         
                ████████                          
█                 █████                           
███               ████                            
████              ███                             
█████              █                              
███████                                           
████████                                          
██████████                                      ██
████████████                                ██████
██████████████                         ███████████
████████████████                   ███████████████
█████████████████              ███████████████████
██████████████████        ████████████████████████
████████████████████  ████████████████████████████
██████████████████████████████████████████████████
██████████████████████████████████████████████████
██████████████████████████████████████████████████
██████████████████████████████████████████████████
██████████████████████████████████████████████████
██████████████████████████████████████████████████
██████████████████████████████████████████████████