77777777777777777777777777777777777777777777777777
77777777777777777777777777777777777777777777777777
77777777777777777777777777777777777777777777777777
77777777777777777777777777777777777777777777777777
77777777777777777777777777777777777777777777777777
77777777777777777777777777777777777777777777777777
77777777777777777777777777777777777777777777777777
77777777777777777777777777777777777777777777777777
77777777777777777777777777777777777777777777777777
77777777777777777777777777777777777777777777777777
77777777777777777777777777777777777777777777777777
77777777777777777777777777777777777777777777777777
77777777777777777777777777777777777777777777777777
77777777777777777777777777777777777777777777777777
77777777777777777777777777777777777777777777777777
77777777777777777777777777777777777777777777777777
77777777777777777777777777777777777777777777777777
  777777777777777777777777777777777777777777777777
  777777777777777777777777777777777777777777777777
  777777777777777777777777777777777777777777777777
   77777777777777777777777777777777777777777777777
       7777777777777777777777777777777777777777777
        777777777777777777777777777777777777777777
           777777777777777777777777777777777777777
            77777777777777777777777777777777777777
             7777777777777777777777777777777777777
              777777777777777777777777777777777777
                7777777777777  7777777777777777777
                     77777     7777777777777777777
                     7777       77777777777777777 
                                    777777777777  
                                        7777777   
                                        7777777   
                                         7777     
                                                  
                                                  
                                                  
                 777777                           
              777777777777777777777777
              777777777777777777777777            
            7777777777777777777777777777777777
        77777777777777777777777777777777777777    
      77777777777777777777777777777777777777777   
  7777777777777777777777777777777777777777777777  
77777777777777777777777777777777777777777777777777
77777777777777777777777777777777777777777777777777
77777777777777777777777777777777777777777777777777
77777777777777777777777777777777777777777777777777
77777777777777777777777777777777777777777777777777
77777777777777777777777777777777777777777777777777