77777777777777777777777777777777777777777777777777
77777777777777777777777777777777777777777777777777
77777777777777777777777777777777777777777777777777
77777777777777777777777777777777777777777777777777
77777777777777777777777777777777777777777777777777
77777777777777777777777777777777777777777777777777
77777777777777777777777777777777777777777777777777
77777777777777777777777777777777777777777777777777
777777777         R         R              R
777777777         R         R              R
777777777         R         R              R
77777777          R         R              R
77777777          R         R              R
77777777          R         R              R
77777777          R         R              R
77777777          R         R              R
77777777          R         R              R
7777777           R         R              R
7777777           R         R              R
7777777           R         R              R
777777            R         T              R
777777            R                        R
777777            R                        R
77777             R                        R
77777             R                        T
7777              R         S                     
777               R         R                     
77                R         R                     
7                 R         R                     
                  R         R              S
                  R         R              R
                  R         R              R
                  T         R              R
                            R              R
                            R              R
                            R              R
                            R              R
                  S         R              R
                  R         R              R
                  R         R              R
                  R         R              R
                  R         R              R
     777          R         R  777777      R
   777777         R         7777777777     R
77777777777777777777777777777777777777777777777777
77777777777777777777777777777777777777777777777777
77777777777777777777777777777777777777777777777777
77777777777777777777777777777777777777777777777777
77777777777777777777777777777777777777777777777777
77777777777777777777777777777777777777777777777777