77777777777777777777777777777777777777777777777777
77777777777777777777777777777777777777777777777777
77777777777777777777777777777777777777777777777777
77777777777777777777777777777777777777777777777777
77777777777777777777777777777777777777777777777777
77777777777777777777777777777777777777777777777777
77777777777777777777777777777777777777777777777777
77777777777777777777777777777777777777777777777777
7           777777777777777777       7777777777777
                                        777777777 
                                          777777  
                                           7777   
 777777777              777777             777    
7777777777777777777777777777777777                
7777777777777777777777777777777777777             
7777777777777777777777777777777777777777          
77777777777777777777777777   777777777777         
77777777        R              77777777777        
7777            R                7777777777       
                R      77777       77777777       
       7777777777777777777777777777777777777      
   777777777777777777777777777777777777777777     
77777777777777777777777777777777777777777777777   
77777777777777777777777777777777777777777777777777
77777777777777777777777777777777777777777777777777
77777777777777777777777777777777777777777777777777
77777777777777777777777777777777777777777777777777
777777777777777777777777777          7777777777777
7777777777777777777777              77777777777777
77777777777777777                   77777777777777
7777                              7777777777777777
7                               777777777777777777
                        77777777777777777777777777
                7777777777777777777777777777777777
      77777777777777777777777777777777777777777777
   77777777777777777777777777777777777777777777777
 7777777777777777777777777777777777777777777777777
77777777777777777777777777777777777777777777777777
77777777777777777777777777777777777777777777777777
77777777777777777777777777777777777777777777777777
77777777777777777777777777777777777777777777777777
77777777777777777777777777777777777777777777777777
77777777777777777777777777777777777777777777777777
77777777777777777777777777777777777777777777777777
77777777777777777777777777777777777777777777777777
77777777777777777777777777777777777777777777777777
77777777777777777777777777777777777777777777777777
77777777777777777777777777777777777777777777777777
77777777777777777777777777777777777777777777777777
77777777777777777777777777777777777777777777777777