00000000000000000000000000000000000000000000000000
00000000000000000000000000000000000000000000000000
00000000000000000000000000000000000000000000000000
00000000000000000000000000000000000000000000000000
00000000000000000000000000000000000000000000000000
00000000000000000000000000000000000000000000000000
00000000000000000000000000000000000000000000000000
00000000000000000000000000000000000000000000000000
00000000000000000000000000000000000000000000000000
000000000000      no        0000000000000   no    
00000000000       no          00000000      no    
000000000         no                        no    
00000000          no                        no    
0000000           no                        no    
000000            no                        no    
0000              no                        no    
0000              no                        no    
                  no                        no    
                  no                        no    
                  no                              
                  no                              
                  no                              
                  no                              
                  no                qp
                  no                no            
                  no                no            
                                    no            
                                    no            
                                    no            
                                    no            
                                    no            
                                    no            
                                    no            
                              qp    no
                              no    no            
                              no    no            
                              no    no            
                              no    no            
                              000000000000        
                            000000000000000       
                     0000000000000000000000000    
                   00000000000000000000000000000  
00000000000000000000000000000000000000000000000000
00000000000000000000000000000000000000000000000000
00000000000000000000000000000000000000000000000000
00000000000000000000000000000000000000000000000000
00000000000000000000000000000000000000000000000000
00000000000000000000000000000000000000000000000000
00000000000000000000000000000000000000000000000000
00000000000000000000000000000000000000000000000000