00000000000000000000000000000000000000000000000000
00000000000000000000000000000000000000000000000000
00000000000000000000000000000000000000000000000000
00000000000000000000000000000000000000000000000000
00000000000000000000000000000000000000000000000000
00000000000000000000000000000000000000000000000000
00000000000000000000000000000000000000000000000000
00000000000000000000000000000000000000000000000000
00000000000000000000000000000000000000000000000000
 0000000000         r         r        r        r 
     00000          r         t        r        r 
      0000          r                  r        r 
                    r                  r        r 
                    r                  r        r 
                    r                  r        r 
                    r                  r        r
                    r         s        r        r
                    r         r        r        r 
                    r         r        r        r 
                    r         r        r        r 
                    r         r        r        r 
                    r         r        r        r 
                    t         r        r        r
                              r        r        r
                              r        r        r 
                              r        t        r
                              r                 r
                    s         r                 r 
                    r         r                 r 
                    r         r                 r 
                    r         r        s        r 
                    r         r        r        r 
                    r         r        r        r 
                    r         r        r        t
                    r         r        r
                    r         r        r          
                    r         r        r          
                    r         r        r          
                    r         r        r          
                    r   00    r        r        s 
                    r   000   r        r        r 
                    r  00000  r        r        r 
00000000000000000000000000000000000000000000000000
00000000000000000000000000000000000000000000000000
00000000000000000000000000000000000000000000000000
00000000000000000000000000000000000000000000000000
00000000000000000000000000000000000000000000000000
00000000000000000000000000000000000000000000000000
00000000000000000000000000000000000000000000000000
00000000000000000000000000000000000000000000000000