00000000000000000000000000000000000000000000000000
00000000000000000000000000000000000000000000000000
00000000000000000000000000000000000000000000000000
00000000000000000000000000000000000000000000000000
00000000000000000000000000000000000000000000000000
00000000000000000000000000000000000000000000000000
00000000000000000000000000000000000000000000000000
00000000000000000000000000000000000000000000000000
00000000000000000000000000000000000000000000000000
       0000000000000000000000000000000000000000000
             r  0000000000000000000000000000000000
             r        0000000000000000000000000000
             r         000000000000000000000000000
             r            000000000000000000000000
             r              0000000000000000000000
             r                00000000000000000000
             r                 0000000000000000000
             r                  000000000000000000
             r                    0000000000000000
             r                      00000000000000
             r                        000000000000
             r                            00000000
             r                               r    
             r                               r    
             r                               t
             r                          s
             r                          r         
             r                          r         
             r                          0000000   
             r                         00000000000
    vvvvvvvvvu                        000000000000
                                     0000000000000
                                    00000000000000
                                   000000000000000
                                  0000000000000000
                                000000000000000000
                                000000000000000000
                             000000000000000000000
                            0000000000000000000000
                        00000000000000000000000000
                0000000000000000000000000000000000
       0000000000000000000000000000000000000000000
00000000000000000000000000000000000000000000000000
00000000000000000000000000000000000000000000000000
00000000000000000000000000000000000000000000000000
00000000000000000000000000000000000000000000000000
00000000000000000000000000000000000000000000000000
00000000000000000000000000000000000000000000000000
00000000000000000000000000000000000000000000000000
00000000000000000000000000000000000000000000000000