            00000000000000000000000000000000000000000000000000000000000000000000                    
              000000000000000000000000000000000000000000000000000000000000000000                    
                 000000000000000000000000000000000000000000000000000000000000                       
                       00000000000000000000000000000000000000000000000                              
                            00000000000000000000000000000000000000                                  
                                   000000000000000000000000000                                      
                                       00000000000000000                                            
                                                                                                    
                                                                                                    
                                                                                                    
                                                                                                    
                                                                                                   0
                                                                                                   0
                                                                                                  00
                                                                                                  00
                                                                                                 000
                                                                                                 000
                                                                                                0000
                                                                                               00000
                                                                                               00000
                                                                                              000000
                                                                                              000000
                                                                                             0000000
                                                                                           000000000
                                                                                       0000000000000
                                                                                       0000000000000
                                                                                     000000000000000
                                                                                   00000000000000000
                                                                                 0000000000000000000
                                                                                 0000000000000000000
                                                                                 0000000000000000000
                                                                                 0000000000000000000
                                                                                  000000000000000000
                                                                                    0000000000000000
                                                                                     000000000000000
                                                                                     000000000000000
                                                                                    0000000000000000
                                                                                    0000000000000000
                                                                                   00000000000000000
                                                                                   00000000000000000
                                                                                 0000000000000000000
                                                                                00000000000000000000
                                                0000000          00000000000000000000000000000000000
   000000000000            000000         0000000000000000000000000000000000000000000000000000000000
000000000000000000       000000000000000000000000000000000000000000000000000000000000000000000000000
0000000000000000000000000000000000000000000000000000000000000000000000000000000000000000000000000000
0000000000000000000000000000000000000000000000000000000000000000000000000000000000000000000000000000
0000000000000000000000000000000000000000000000000000000000000000000000000000000000000000000000000000
0000000000000000000000000000000000000000000000000000000000000000000000000000000000000000000000000000
0000000000000000000000000000000000000000000000000000000000000000000000000000000000000000000000000000