00000000000000000000000000000000000000000000000000
00000000000000000000000000000000000000000000000000
00000000000000000000000000000000000000000000000000
00000000000000000000000000000000000000000000000000
00000000000000000000000000000000000000000000000000
00000000000000000000000000000000000000000000000000
00000000000000000000000000000000000000000000000000
00000000000000000000000000000000000000000000000000
00000000000000000000000000000000000000000000000000
00000000000000000000000000000000000000000000000000
00000000000000000000000000000000000000000000000000
00000000000000000000000000000000000000000000000000
00000000000000000000000000000000000000000000000000
00000000000000000000000000000000000000000000000000
00000000000000000000000000000000000000000000000000
00000000000000000000000000000000000000000000000000
00000000000000000000000000000000000000000000000000
00000000000000000000000000000000000000000000000000
00000000000000000000000000000000000000000000000000
00000000000000000000000000000000000000000000000000
00000000000000000000000000                        
0000000000000                                     
00000000                                          
00000                                             
000                                               
0                                                 
                                                  
                                                  
                                                  
                                                  
                                                  
                                                  
                                                  
                                            000000
                                 0 000000000000000
                             000000000000000000000
                         0000000000000000000000000
                       000000000000000000000000000
                     00000000000000000000000000000
                   0000000000000000000000000000000
                0000000000000000000000000000000000
              000000000000000000000000000000000000
             0000000000000000000000000000000000000
           000000000000000000000000000000000000000
          0000000000000000000000000000000000000000
          0000000000000000000000000000000000000000
         00000000000000000000000000000000000000000
         00000000000000000000000000000000000000000
         00000000000000000000000000000000000000000
         00000000000000000000000000000000000000000