                                                  
                                                  
                                                  
                                                  
                                                  
                                                  
                                                  
                                                  
                                                  
                                                  
                                                  
                                                  
                                              0000
                                            000
                                         000
                                        00
                                       00
                                       0
                                       0
                                       0
                                       0
                                      0
                                      0
                                      0
                                    000
                                   00
                                  00
                                000
                                0
                                0
                               00
                               0
                              00
                             00
                            00
                           0
                          00
                          0
                          0
                          0
                         00
                        00
                       00
                     000
0000000000000000000000




